...........########
...........#..SSSS#
############..SSSS#
#....#..B.B...SSSS#
#.BBB#B..B.#..SSSS#
#..B.....B.#..SSSS#
#.BB.#B.B.B########
#..B.#.....#
##.#########
#....#....##
#.....B...##
#..BB#BB..A#
#....#....##
###########
